NAME,NFTGD_NB,FTGD_NB,SUBSUMED,NEW_FTGD_NB,NEW_NFTGD_NB,NEW_OUTPUT_SIZE,OUTPUT_SIZE,TIME
00001,253,2475,153259,43660,130468,54,2529,65982
00002,431,942,4763,2002,2893,161,1103,3198
00003,16709,3263,58265,5137,107517,139,3402,TIMEOUT
00004,16705,2107,16833,389,78642,0,2107,TIMEOUT
00005,16705,3211,50329,893,104463,0,3211,TIMEOUT
00006,1075,165,2,0,2,0,165,370
00007,22,169,44,8,37,0,169,276
00008,22,169,45,7,39,0,169,250
00009,22,169,45,7,39,0,169,250
00010,22,169,44,5,40,0,169,264
00011,22,169,45,9,37,0,169,276
00012,12,279,21,3,18,0,279,218
00013,74,1265,1054769,351140,720297,104,1369,TIMEOUT
00014,130,1545,524287,250693,281669,9,1554,TIMEOUT
00015,13,345,4905,1756,3330,11,356,3468
00016,64,1055,953221,274335,691983,87,1142,259244
00017,64,1177,958622,291625,679647,87,1264,TIMEOUT
00018,84,1136,936039,341442,606240,69,1205,TIMEOUT
00019,67,1078,954061,319265,647403,69,1147,TIMEOUT
00020,80,1315,749315,256717,503862,22,1337,TIMEOUT
00021,104,1197,1001069,252441,761597,149,1346,272366
00022,13,425,4158,1567,2772,11,436,3632
00023,13,429,6029,2339,3871,11,440,4145
00024,130,1545,484165,227556,265821,9,1554,TIMEOUT
00025,66,987,837,395,464,23,1010,1081
00026,23858,30697,83639,4213,80706,6,30703,TIMEOUT
00027,23858,31647,55885,1383,55606,6,31653,TIMEOUT
00028,23858,31647,49200,1662,48634,6,31653,TIMEOUT
00029,1776,4039,178695,0,182526,0,4039,TIMEOUT
00030,2096,3626,364715,0,369764,0,3626,TIMEOUT
00031,2096,3626,316261,0,319795,0,3626,TIMEOUT
00032,2096,4039,180947,0,182859,0,4039,TIMEOUT
00033,12339,9462,18733,2261,18950,1,9463,TIMEOUT
00034,12339,9364,266523,86694,193062,12232,21596,TIMEOUT
00035,12339,9462,17308,2344,17530,1,9463,TIMEOUT
00036,12329,9456,18254,2504,17636,1,9457,TIMEOUT
00037,12323,9445,25534,2524,25009,1,9446,TIMEOUT
00038,12339,9457,25046,2587,24994,1,9458,TIMEOUT
00039,2437,4826,311584,0,313769,0,4826,TIMEOUT
00040,43604,100787,12159,653,12901,0,100787,TIMEOUT
00041,14319,67437,37117,2685,36858,427,67864,TIMEOUT
00042,15417,71082,40853,3467,40726,813,71895,TIMEOUT
00044,14319,67400,33813,1762,35140,427,67827,TIMEOUT
00045,42412,98673,12447,2616,11436,78,98751,TIMEOUT
00046,15352,69253,36355,1351,37972,427,69680,TIMEOUT
00047,14431,67545,36934,1389,38334,427,67972,TIMEOUT
00048,14739,70580,36319,1767,37148,432,71012,TIMEOUT
00049,15,52,192,91,109,8,60,459
00050,15,51,134,63,79,8,59,399
00051,0,0,0,0,0,0,0,72
00052,3764,25233,20245,0,20243,0,25233,20428
00053,0,1129,0,0,0,0,1129,392
00054,0,3,0,0,0,0,3,146
00055,23,212,61,9,64,2,214,430
00056,0,12,0,0,0,0,12,113
00057,3,11,6,0,6,0,11,225
00058,3,7,3,0,3,0,7,158
00059,5,47,5,0,5,0,47,204
00060,9,72,10,0,10,0,72,197
00061,0,6,0,0,0,0,6,111
00062,10,72,10,0,10,0,72,215
00063,12,61,12,0,12,0,61,216
00064,0,3,0,0,0,0,3,118
00065,3,12,5,0,5,0,12,183
00066,1,20,1,0,1,0,20,163
00067,0,24,0,0,0,0,24,116
00068,2,33,2,0,2,0,33,148
00069,1,8,1,0,1,0,8,134
00070,0,42,0,0,0,0,42,117
00071,1,14,1,0,1,0,14,224
00072,1,31,1,0,1,0,31,150
00073,6,77,8,3,6,1,78,226
00074,0,21,0,0,0,0,21,160
00075,2,125,2,1,2,1,126,229
00076,0,186,0,0,0,0,186,197
00077,0,4,0,0,0,0,4,124
00078,10,748,74,23,56,5,753,335
00079,2,32,2,0,2,0,32,341
00080,0,26,0,0,0,0,26,160
00081,93,679,94,0,94,0,679,675
00082,196,263,610,6,606,2,265,865
00083,0,15,0,0,0,0,15,169
00084,0,4,0,0,0,0,4,177
00085,0,2,0,0,0,0,2,119
00086,0,0,0,0,0,0,0,104
00087,0,77,0,0,0,0,77,161
00088,0,105,0,0,0,0,105,149
00089,0,87,0,0,0,0,87,141
00090,0,66,0,0,0,0,66,124
00091,0,13,0,0,0,0,13,102
00092,0,32,0,0,0,0,32,106
00093,0,216,0,0,0,0,216,139
00094,17,138,51,30,32,11,149,232
00095,0,63,0,0,0,0,63,174
00096,0,0,0,0,0,0,0,70
00097,0,0,0,0,0,0,0,98
00098,0,0,0,0,0,0,0,88
00099,0,0,0,0,0,0,0,70
00100,0,0,0,0,0,0,0,73
00101,0,0,0,0,0,0,0,66
00102,0,0,0,0,0,0,0,82
00103,0,263,0,0,0,0,263,207
00104,0,1124,0,0,0,0,1124,333
00105,0,11,0,0,0,0,11,205
00106,4,43,6,0,6,0,43,186
00107,0,22,0,0,0,0,22,224
00108,0,16,0,0,0,0,16,166
00109,0,83,0,0,0,0,83,207
00110,172,244,528,4,525,1,245,874
00111,0,44,0,0,0,0,44,136
00112,15,118,41,12,30,0,118,367
00113,12,24,8,0,9,0,24,195
00114,12,43,212,101,156,27,70,665
00115,0,216,0,0,0,0,216,197
00116,5,37,14,6,12,3,40,302
00117,2437,4826,362685,0,367378,0,4826,TIMEOUT
00118,18,89,202,61,175,16,105,609
00119,0,3,0,0,0,0,3,122
00120,8,55,32,20,18,6,61,297
00121,0,0,0,0,0,0,0,83
00122,0,2,0,0,0,0,2,114
00123,0,0,0,0,0,0,0,77
00124,0,0,0,0,0,0,0,73
00125,0,0,0,0,0,0,0,78
00126,0,0,0,0,0,0,0,78
00127,0,0,0,0,0,0,0,82
00128,0,1,0,0,0,0,1,145
00129,0,13,0,0,0,0,13,137
00130,0,3,0,0,0,0,3,131
00131,0,0,0,0,0,0,0,79
00132,0,18,0,0,0,0,18,117
00133,0,10,0,0,0,0,10,127
00134,0,0,0,0,0,0,0,83
00135,0,55,0,0,0,0,55,138
00136,0,48,0,0,0,0,48,145
00137,0,158,0,0,0,0,158,171
00138,0,384,0,0,0,0,384,198
00139,0,145,0,0,0,0,145,169
00140,0,511,0,0,0,0,511,230
00141,0,116,0,0,0,0,116,174
00142,0,604,0,0,0,0,604,212
00143,0,187,0,0,0,0,187,171
00144,0,2168,0,0,0,0,2168,295
00145,0,60,0,0,0,0,60,143
00146,0,1211,0,0,0,0,1211,249
00147,0,4,0,0,0,0,4,115
00148,0,629,0,0,0,0,629,226
00149,0,213,0,0,0,0,213,199
00150,0,84,0,0,0,0,84,143
00151,48,263,164539,12017,155708,29,292,27883
00152,0,22,0,0,0,0,22,109
00153,24,186,2,0,2,0,186,235
00154,0,6,0,0,0,0,6,103
00155,0,86,0,0,0,0,86,244
00156,0,0,0,0,0,0,0,81
00157,0,438,0,0,0,0,438,214
00159,0,316,0,0,0,0,316,302
00161,0,0,0,0,0,0,0,91
00162,0,9,0,0,0,0,9,127
00163,0,31,0,0,0,0,31,149
00164,3,31,0,1,0,1,32,224
00165,0,125,0,0,0,0,125,230
00166,0,10,0,0,0,0,10,124
00167,12,456,115,14,105,1,457,511
00168,0,50,0,0,0,0,50,153
00169,22,169,46,6,41,0,169,341
00170,9,121,15,4,11,0,121,310
00171,12,61,21,0,21,0,61,325
00172,108,190,23618,1781,22913,26,216,5177
00173,120,98,673,293,407,29,127,908
00174,1776,3626,323222,0,328141,0,3626,TIMEOUT
00175,0,216,0,0,0,0,216,184
00176,28,76,74,21,75,12,88,307
00177,0,357,0,0,0,0,357,158
00178,0,46,0,0,0,0,46,133
00179,0,25,0,0,0,0,25,128
00180,0,0,0,0,0,0,0,114
00181,0,0,0,0,0,0,0,98
00182,0,0,0,0,0,0,0,87
00183,0,0,0,0,0,0,0,71
00184,0,0,0,0,0,0,0,82
00185,0,0,0,0,0,0,0,84
00186,0,0,0,0,0,0,0,85
00187,0,0,0,0,0,0,0,89
00188,0,0,0,0,0,0,0,76
00189,0,7,0,0,0,0,7,123
00190,0,12,0,0,0,0,12,121
00191,0,0,0,0,0,0,0,75
00192,0,0,0,0,0,0,0,74
00193,0,116,0,0,0,0,116,172
00194,0,0,0,0,0,0,0,76
00195,0,155,0,0,0,0,155,165
00196,0,36,0,0,0,0,36,125
00197,0,80,0,0,0,0,80,154
00198,0,85,0,0,0,0,85,155
00199,0,0,0,0,0,0,0,93
00200,0,42,0,0,0,0,42,131
00201,0,25,0,0,0,0,25,128
00202,0,225,0,0,0,0,225,199
00203,0,21,0,0,0,0,21,126
00204,0,67,0,0,0,0,67,150
00205,0,5,0,0,0,0,5,132
00206,0,8,0,0,0,0,8,130
00207,0,8,0,0,0,0,8,171
00208,0,9,0,0,0,0,9,166
00209,18,27,21,0,21,0,27,245
00210,5,19,10,0,10,0,19,201
00211,0,106,0,0,0,0,106,286
00212,2,3,2,0,2,0,3,136
00213,2,3,2,0,2,0,3,163
00214,11,21,18,0,18,0,21,182
00215,7,10,16,0,16,0,10,155
00216,0,7,0,0,0,0,7,133
00217,1,8,1,0,1,0,8,184
00218,6,8,7,0,7,0,8,193
00219,0,18,0,0,0,0,18,134
00220,2,3,2,0,2,0,3,167
00221,1,16,3,0,3,0,16,186
00222,5,51,12,0,12,0,51,232
00223,4,8,7,0,7,0,8,262
00224,2,7,3,0,3,0,7,168
00225,0,3,0,0,0,0,3,125
00226,0,5,0,0,0,0,5,128
00227,0,6,0,0,0,0,6,129
00228,0,12,0,0,0,0,12,154
00229,2,36,10,5,6,0,36,182
00230,2,5,2,0,2,0,5,173
00231,0,4,0,0,0,0,4,145
00232,0,38,0,0,0,0,38,148
00233,1,4,1,0,1,0,4,222
00234,0,8,0,0,0,0,8,154
00235,6,18,10,0,10,0,18,217
00236,6,22,6,0,6,0,22,226
00237,1,2,1,0,1,0,2,190
00238,5,17,14,0,14,0,17,257
00239,0,215,0,0,0,0,215,223
00240,0,51,0,0,0,0,51,168
00241,1,28,3,0,3,0,28,191
00242,5,16,14,0,14,0,16,179
00243,0,83,0,0,0,0,83,157
00244,0,0,0,0,0,0,0,88
00245,0,0,0,0,0,0,0,87
00246,0,0,0,0,0,0,0,88
00247,0,0,0,0,0,0,0,85
00248,0,101,0,0,0,0,101,213
00249,0,97,0,0,0,0,97,265
00250,0,111,0,0,0,0,111,179
00251,0,104,0,0,0,0,104,152
00252,0,107,0,0,0,0,107,177
00253,0,103,0,0,0,0,103,170
00254,0,164,0,0,0,0,164,197
00255,0,17,0,0,0,0,17,130
00256,0,65,0,0,0,0,65,135
00257,0,0,0,0,0,0,0,77
00258,0,0,0,0,0,0,0,77
00259,0,6,0,0,0,0,6,112
00260,0,0,0,0,0,0,0,79
00261,0,1,0,0,0,0,1,119
00262,0,1,0,0,0,0,1,129
00263,0,0,0,0,0,0,0,86
00264,0,2,0,0,0,0,2,128
00265,0,0,0,0,0,0,0,71
00266,0,17,0,0,0,0,17,118
00267,4,7,4,0,4,0,7,160
00268,0,3,0,0,0,0,3,131
00269,0,72,0,0,0,0,72,180
00270,0,63,0,0,0,0,63,162
00271,0,65,0,0,0,0,65,153
00272,0,77,0,0,0,0,77,198
00273,0,71,0,0,0,0,71,142
00274,0,94,0,0,0,0,94,172
00275,0,127,0,0,0,0,127,174
00276,0,13,0,0,0,0,13,120
00277,0,101,0,0,0,0,101,157
00278,0,0,0,0,0,0,0,81
00279,26,168,38,0,38,0,168,255
00280,0,257,0,0,0,0,257,156
00281,13,345,3936,1361,2756,11,356,2823
00282,65,883,1084285,319230,777952,90,973,TIMEOUT
00283,85,967,874505,313083,573860,72,1039,TIMEOUT
00284,81,1227,1206423,189086,1027135,7,1234,TIMEOUT
00285,66179,53294,3671561,68856,3612228,1060,54354,TIMEOUT
00286,13961,32979,153872,56484,103730,6409,39388,92671
00287,0,25,0,0,0,0,25,109
00288,0,84,0,0,0,0,84,124
00289,0,35,0,0,0,0,35,116
00290,7,137,24,0,30,0,137,233
00292,0,31,0,0,0,0,31,117
00293,16,2083,16,0,16,0,2083,267
00294,0,41,0,0,0,0,41,118
00295,0,42,0,0,0,0,42,118
00296,16,66,70,33,36,0,66,261
00297,0,71,0,0,0,0,71,122
00298,0,81,0,0,0,0,81,127
00299,0,9,0,0,0,0,9,106
00300,0,0,0,0,0,0,0,75
00301,3,134,5,2,3,0,134,179
00302,0,374,0,0,0,0,374,159
00303,0,361,0,0,0,0,361,161
00304,0,38,0,0,0,0,38,109
00305,0,20,0,0,0,0,20,109
00306,0,14,0,0,0,0,14,106
00307,0,0,0,0,0,0,0,67
00308,0,7,0,0,0,0,7,105
00309,0,83,0,0,0,0,83,150
00310,0,22,0,0,0,0,22,117
00311,0,22,0,0,0,0,22,107
00312,0,23,0,0,0,0,23,104
00313,0,0,0,0,0,0,0,67
00314,0,0,0,0,0,0,0,92
00315,0,9,0,0,0,0,9,104
00316,1,42,1,0,1,0,42,143
00317,0,0,0,0,0,0,0,63
00318,0,67,0,0,0,0,67,120
00319,12,417,2353925,718981,1638284,254,671,TIMEOUT
00320,8,261,22,0,22,0,261,210
00321,0,0,0,0,0,0,0,70
00322,0,1697,0,0,0,0,1697,409
00323,0,12,0,0,0,0,12,112
00324,0,48,0,0,0,0,48,123
00325,0,1,0,0,0,0,1,97
00326,0,0,0,0,0,0,0,67
00327,0,0,0,0,0,0,0,73
00328,0,51,0,0,0,0,51,118
00329,0,16,0,0,0,0,16,118
00330,0,3,0,0,0,0,3,98
00331,0,9,0,0,0,0,9,104
00332,9,228,32,13,21,2,230,207
00333,5,66,18,10,9,1,67,194
00334,9,228,42,23,21,2,230,229
00335,0,33,0,0,0,0,33,116
00336,9,228,42,23,21,2,230,262
00337,0,27,0,0,0,0,27,111
00338,9,228,33,14,21,2,230,205
00339,4,93,17,10,8,1,94,194
00340,9,228,42,23,21,2,230,224
00341,2,33,2,3,2,3,36,164
00342,0,11,0,0,0,0,11,102
00343,4,156,2506719,1,2526569,1,157,TIMEOUT
00344,12,417,2219391,615733,1609636,447,864,TIMEOUT
00345,12,417,2258116,772092,1490543,353,770,TIMEOUT
00346,8,261,22,0,22,0,261,204
00347,8,98,48,13,41,6,104,235
00348,12,166,79,23,65,9,175,315
00349,8,98,55,16,45,6,104,253
00350,934,3026,65974,22826,47855,2,3028,TIMEOUT
00352,221,3256,147641,82577,83496,18432,21688,18372
00353,221,3235,240287,128857,129862,18432,21667,20750
00354,1417,4648,25849,0,30490,0,4648,TIMEOUT
00355,0,131,0,0,0,0,131,123
00356,1719,1901,1745,0,1744,0,1901,1866
00357,1794,1981,2118,0,2117,0,1981,2140
00358,101,267,655,0,650,0,267,604
00359,515,181,219,0,219,0,181,506
00360,1059,1616,3403,0,3403,0,1616,3005
00361,0,326,0,0,0,0,326,157
00362,0,57,0,0,0,0,57,139
00363,0,70,0,0,0,0,70,132
00364,0,37,0,0,0,0,37,120
00365,0,38,0,0,0,0,38,113
00366,40,96,137,0,137,0,96,535
00367,40,96,137,0,137,0,96,385
00368,6657,25628,54641,0,54641,0,25628,54300
00369,10978,39919,103646,0,103646,0,39919,185052
00370,12070,56379,111832,0,111832,0,56379,215149
00371,7464,27758,69501,2909,67203,617,28375,75112
00372,557,1077,709,176,709,176,1253,2478
00373,668,1297,832,189,832,189,1486,2295
00374,8270,30220,106300,13470,100147,7317,37537,135841
00375,12632,45457,137522,13506,130532,6516,51973,TIMEOUT
00376,694,1286,7648,7016,7647,7015,8301,5196
00377,570,1006,6860,6376,6860,6376,7382,5212
00378,21423,58205,106543,0,106531,0,58205,TIMEOUT
00380,3141,6000,3256,302,3256,302,6302,22954
00381,3216,6053,3499,534,3499,534,6587,26549
00382,8378,47281,113826,44023,79236,9433,56714,TIMEOUT
00383,13719,65847,108118,43094,71814,6800,72647,TIMEOUT
00384,732,548,5985,2503,4130,648,1196,2740
00385,829,573,9407,4329,6242,1165,1737,4194
00386,7559,28570,56945,62,56920,37,28607,63751
00387,12025,44320,196656,53592,162166,19102,63422,TIMEOUT
00388,106,212,138,32,138,32,244,513
00389,100,200,100,0,100,0,200,710
00390,7029,26439,145825,49709,110730,14646,41085,251188
00391,11279,40960,99807,32087,76781,9075,50035,TIMEOUT
00392,608,1213,9138,8385,9032,8279,9492,10276
00393,776,1552,8569,6655,7511,5597,7149,13575
00394,9071,31193,77952,5510,74384,1943,33135,150812
00395,21788,60146,104154,5799,104106,5751,65897,TIMEOUT
00396,597,1153,1189,619,1189,619,1772,2896
00397,1494,2922,7250,5799,7250,5799,8721,14194
00398,7419,27696,68544,2648,66382,492,28188,73192
00399,512,991,612,122,612,122,1113,2082
00400,7999,29907,72765,3306,70155,696,30603,82503
00401,423,786,854,470,854,470,1256,2132
00402,1627,2230,1552,0,1550,0,2230,1632
00403,2479,3894,2709,0,2702,0,3894,2526
00404,2,45,6,0,6,0,45,179
00405,4,49,14,0,14,0,49,201
00406,2,92,9,0,9,0,92,188
00407,4,97,19,0,19,0,97,217
00408,0,10,0,0,0,0,10,100
00409,0,10,0,0,0,0,10,106
00410,471,1339,63680,5929,63677,33,1372,TIMEOUT
00411,250,1199,1739,0,1735,0,1199,1298
00412,919,3532,7049,0,7049,0,3532,4777
00413,1085,4625,8145,0,8145,0,4625,5050
00414,25,50,27,2,27,2,52,448
00415,7752,39986,64135,135,64028,28,40014,73963
00416,12269,56650,115228,353,114906,31,56681,243473
00417,176,343,170,0,170,0,343,1632
00418,202,395,198,2,198,2,397,2399
00419,1496,4468,62257,25070,42501,5315,9783,57961
00420,1480,5169,25236,5424,20682,905,6074,16164
00421,716,1271,10592,5971,7999,3378,4649,7792
00422,420,672,2458,688,2149,379,1051,3397
00423,619,714,1193,0,1193,0,714,1133
00424,728,1463,6060,1607,5109,656,2119,5270
00425,11625,26750,185015,0,184994,0,26750,TIMEOUT
00426,24421,44891,119271,0,119242,0,44891,TIMEOUT
00427,261,729,17491,1677,16197,296,1025,5785
00428,0,0,0,0,0,0,0,78
00429,0,0,0,0,0,0,0,74
00430,359,178,495,0,495,0,178,529
00431,359,178,494,0,494,0,178,554
00432,238,137,636,0,636,0,137,614
00433,242,137,644,0,644,0,137,554
00434,0,21034,0,0,0,0,21034,822
00435,1,9081,0,0,0,0,9081,470
00436,2308,24014,240654,122979,146504,28839,52853,239183
00437,44247,90904,162280,83980,96895,18595,109499,TIMEOUT
00438,1512,3024,20898,19386,20898,19386,22410,45565
00439,0,0,0,0,0,0,0,102
00440,0,0,0,0,0,0,0,88
00441,0,0,0,0,0,0,0,96
00442,0,0,0,0,0,0,0,74
00443,13730,0,0,0,0,0,0,1404
00444,13730,0,0,0,0,0,0,1260
00445,120,1222,480,0,479,0,1222,632
00446,164,1659,1297,290,1094,88,1747,1271
00447,164,1659,1296,290,1093,88,1747,1311
00448,24847,49406,112189,0,112164,0,49406,TIMEOUT
00449,207,2013,2655,525,2278,149,2162,2586
00450,341,2838,5993,2787,3524,309,3147,2971
00451,2257,2862,11824,0,11756,0,2862,5390
00452,3163,4116,19705,0,19654,0,4116,9542
00453,0,157,0,0,0,0,157,145
00454,69,347,8923,5858,6061,2996,3343,2055
00455,0,990,0,0,0,0,990,195
00456,0,990,0,0,0,0,990,241
00457,80,1604,460,0,460,0,1604,680
00458,80,1604,460,0,460,0,1604,705
00459,4013,6900,26826,1695,25555,430,7330,15713
00460,9023,10382,98841,4672,94829,682,11064,65952
00461,9023,10382,101717,7559,94818,682,11064,74502
00462,9433,13435,700593,368553,385358,53319,66754,TIMEOUT
00463,9433,10339,669262,352476,368203,51417,61756,TIMEOUT
00464,229,6,0,0,0,0,6,180
00465,282,132,789,0,789,0,132,719
00466,0,6603,0,0,0,0,6603,374
00467,0,6603,0,0,0,0,6603,349
00468,5,720,25,0,25,0,720,404
00469,53,878,197,0,197,0,878,403
00470,44414,75146,158088,0,157975,0,75146,TIMEOUT
00471,42734,78977,67165,0,67138,0,78977,TIMEOUT
00472,44414,75146,144711,0,144602,0,75146,TIMEOUT
00473,42734,78977,63311,0,63297,0,78977,TIMEOUT
00474,16,72,40,0,40,0,72,255
00475,22,83,66,0,66,0,83,303
00476,1834,2687,4105,2388,4040,2329,5016,9783
00477,156743,10606,N/A,N/A,N/A,N/A,N/A,ERROR
00478,0,937,0,0,0,0,937,250
00479,317,566,739353,14472,731104,6,572,TIMEOUT
00480,320,677,793046,34001,769530,7,684,TIMEOUT
00481,0,0,0,0,0,0,0,76
00482,0,0,0,0,0,0,0,78
00483,29022,114239,N/A,N/A,N/A,N/A,N/A,ERROR
00485,2593,5291,2839,164,2835,160,5451,27002
00486,7777,46980,108253,41610,75908,9265,56245,TIMEOUT
00487,13015,65519,104639,40685,71699,7755,73274,TIMEOUT
00488,7777,46967,109884,43414,74782,8312,55279,TIMEOUT
00489,9507,52445,101009,40485,68773,8249,60694,TIMEOUT
00490,0,0,0,0,0,0,0,79
00491,0,0,0,0,0,0,0,82
00492,0,0,0,0,0,0,0,103
00493,0,76,0,0,0,0,76,126
00494,N/A,N/A,N/A,N/A,N/A,N/A,N/A,ERROR
00495,N/A,N/A,N/A,N/A,N/A,N/A,N/A,ERROR
00496,10238,3219,37781,0,37776,0,3219,16215
00497,8316,23,50,0,50,0,23,1258
00498,8316,23,50,0,50,0,23,1214
00499,0,13044,0,0,0,0,13044,561
00500,1621,1988,3168,2381,3168,2381,4369,13235
00501,0,0,0,0,0,0,0,58
00502,1878,1926,10482,2,10482,2,1928,5714
00503,0,258,0,0,0,0,258,155
00504,48,636,576,213,398,35,671,721
00505,9,151,9,0,9,0,151,200
00506,168,701,8075,795,7743,139,840,4555
00507,287,1047,799780,81078,753465,309,1356,163360
00508,50,267,445,92,381,18,285,684
00509,0,0,0,0,0,0,0,70
00510,0,0,0,0,0,0,0,71
00511,346,282,1110850,97693,1027744,1,283,TIMEOUT
00512,369,800,9135,4879,4672,216,1016,3903
00513,38,309,208,0,208,0,309,439
00514,38,309,208,0,208,0,309,405
00515,870,2366,3533,0,3533,0,2366,2382
00516,0,7989,0,0,0,0,7989,384
00517,0,11177,0,0,0,0,11177,479
00518,11035,9363,42564,25149,33790,16376,25739,TIMEOUT
00519,73,93,8,0,8,0,93,200
00520,76,91,8,0,8,0,91,195
00521,7276,3640,7264,0,7264,0,3640,5567
00522,4233,169,405,0,405,0,169,1521
00523,4233,169,405,0,405,0,169,1401
00524,0,0,0,0,0,0,0,77
00525,0,0,0,0,0,0,0,59
00526,193,288,633,6,629,2,290,770
00527,502,4,0,0,0,0,4,235
00528,0,0,0,0,0,0,0,63
00529,0,0,0,0,0,0,0,62
00530,3,10609,20,0,20,0,10609,551
00531,7,11839,41,0,41,0,11839,619
00532,11943,38045,169501,0,169480,0,38045,TIMEOUT
00534,315,630,315,0,315,0,630,2456
00535,8479,4621,3926,2436,3926,2436,7057,59860
00536,6762,36438,57232,766,56600,134,36572,89188
00537,11089,51961,106541,847,105858,164,52125,233116
00538,102,204,102,0,102,0,204,695
00539,104,208,106,2,106,2,210,620
00540,1654,13265,13579,3150,11254,826,14090,19500
00541,9119,27085,113495,11991,112678,47,27132,TIMEOUT
00542,9,18,9,0,9,0,18,218
00543,9,18,9,0,9,0,18,227
00544,5972,3271,31322,0,31319,0,3271,26008
00545,6276,3351,32847,0,32845,0,3351,27155
00546,1952,775,3920,0,3920,0,775,2882
00547,1952,780,3924,0,3924,0,780,2926
00548,93,4361,593,0,593,0,4361,742
00549,0,458,0,0,0,0,458,165
00550,3,853,13,0,13,0,853,235
00551,0,0,0,0,0,0,0,64
00552,0,0,0,0,0,0,0,62
00553,50566,90262,N/A,N/A,N/A,N/A,N/A,ERROR
00555,133,991,752,201,624,73,1064,1221
00556,496,1524,25288,8237,17689,400,1924,9114
00558,0,0,0,0,0,0,0,73
00559,0,0,0,0,0,0,0,73
00560,9,130,133,42,94,3,133,558
00561,107,662,2439,1104,1526,191,853,1197
00562,57,710,202,0,202,0,710,396
00563,75,983,299,0,299,0,983,510
00564,0,0,0,0,0,0,0,100
00565,0,0,0,0,0,0,0,62
00566,2504,49982,64877,1944,64498,27,50009,33601
00567,0,516,0,0,0,0,516,163
00568,0,516,0,0,0,0,516,176
00569,915,1701,9906,3144,7503,741,2442,7185
00570,38,1102,158,0,158,0,1102,410
00571,39,1357,221,0,221,0,1357,759
00572,19594,57494,112028,0,112016,0,57494,TIMEOUT
00574,478,736,2044,1726,2044,1726,2462,4312
00575,479,700,4389,2574,3370,1555,2255,5459
00576,26,65,416,169,271,24,89,588
00577,15,16,15,0,15,0,16,223
00578,619,714,1193,0,1193,0,714,1261
00579,728,1463,7757,2412,6001,656,2119,7530
00580,8,272,18,0,18,0,272,208
00581,5,316,16,0,16,0,316,186
00582,137,620,839,86,781,28,648,894
00583,0,0,0,0,0,0,0,60
00584,0,0,0,0,0,0,0,60
00585,0,0,0,0,0,0,0,79
00586,0,0,0,0,0,0,0,63
00587,0,0,0,0,0,0,0,72
00588,0,0,0,0,0,0,0,69
00589,112,939,369,0,369,0,939,565
00590,12,608,10220,927,9848,7,615,6470
00591,69,2529,287,0,287,0,2529,692
00592,106,3414,945,0,945,0,3414,1291
00593,192,2049,406,0,397,0,2049,622
00594,177,1984,577,0,577,0,1984,708
00595,219,2703,61663,39571,40524,18432,21135,16325
00596,181,2022,754,0,754,0,2022,939
00597,223,2742,148723,83306,83849,18432,21174,16860
00598,4,1,0,0,0,0,1,125
00599,4,1,0,0,0,0,1,126
00600,177,1983,577,0,577,0,1983,593
00601,0,0,0,0,0,0,0,60
00602,0,0,0,0,0,0,0,60
00603,0,20,0,0,0,0,20,107
00604,0,32,0,0,0,0,32,110
00605,84,650,442,0,442,0,650,646
00606,84,650,442,0,442,0,650,691
00607,0,0,0,0,0,0,0,61
00608,0,0,0,0,0,0,0,70
00609,0,202,0,0,0,0,202,129
00610,0,81,0,0,0,0,81,124
00611,0,24,0,0,0,0,24,110
00612,0,81,0,0,0,0,81,141
00613,0,94,0,0,0,0,94,144
00614,0,24,0,0,0,0,24,116
00615,0,24,0,0,0,0,24,113
00616,0,64,0,0,0,0,64,137
00617,0,63,0,0,0,0,63,137
00618,0,44,0,0,0,0,44,117
00619,0,31,0,0,0,0,31,115
00620,0,58,0,0,0,0,58,129
00621,0,70,0,0,0,0,70,138
00622,0,38,0,0,0,0,38,134
00623,0,38,0,0,0,0,38,128
00624,98,980,580393,108422,513736,9,989,TIMEOUT
00625,0,0,0,0,0,0,0,84
00626,500,1931,4405,667,4002,264,2195,3907
00627,572,2221,3344,0,3344,0,2221,2307
00628,500,1931,4619,746,4137,264,2195,3842
00629,572,2221,3344,0,3344,0,2221,2011
00630,500,1931,4407,668,4003,264,2195,4308
00631,572,2452,5957,1144,5163,350,2802,5554
00632,500,1895,4465,711,4049,295,2190,4657
00633,572,2452,5947,1164,5133,350,2802,4822
00634,0,0,0,0,0,0,0,60
00635,0,0,0,0,0,0,0,62
00636,1615,1010,49667,492,56143,363,1373,13531
00637,92,181,327,127,252,52,233,592
00638,124,204,511,229,398,116,320,868
00639,353,254,256,0,254,0,254,465
00640,408,394,374,0,373,0,394,559
00641,0,0,0,0,0,0,0,67
00642,0,0,0,0,0,0,0,63
00643,0,456,0,0,0,0,456,159
00644,0,638,0,0,0,0,638,190
00645,2091,1594,6879,0,6877,0,1594,3784
00646,2532,2301,9417,0,9415,0,2301,5726
00647,0,36500,0,0,0,0,36500,1244
00648,4,232,14,0,14,0,232,191
00649,663,284,1742,0,1742,0,284,1334
00650,663,284,1742,0,1742,0,284,1450
00651,0,0,0,0,0,0,0,72
00652,0,0,0,0,0,0,0,70
00653,0,0,0,0,0,0,0,65
00654,0,0,0,0,0,0,0,77
00655,0,27,0,0,0,0,27,114
00656,0,27,0,0,0,0,27,121
00657,1642,2580,11791,2355,10261,826,3405,16822
00658,9103,15170,109698,12123,109122,47,15217,TIMEOUT
00659,0,12341,0,0,0,0,12341,524
00660,6673,13597,22004,288,24103,56,13653,TIMEOUT
00661,0,0,0,0,0,0,0,58
00662,0,0,0,0,0,0,0,66
00663,0,0,0,0,0,0,0,66
00664,0,0,0,0,0,0,0,66
00665,299,2975,79946,48609,49757,18432,21407,16112
00666,269,2153,71783,45145,45456,18818,20971,13466
00667,1181,506,2675,0,2675,0,506,2184
00669,3530,4880,4337,0,4337,0,4880,3495
00670,7079,5693,22966,0,22966,0,5693,15394
00671,0,71,0,0,0,0,71,120
00672,0,71,0,0,0,0,71,118
00673,115,1929,313,0,313,0,1929,526
00674,0,2349,0,0,0,0,2349,229
00675,25194,67697,84976,0,84965,0,67697,TIMEOUT
00676,1921,1662,3791,3106,3779,3094,4756,11809
00677,1607,1282,2985,2644,2985,2644,3926,7062
00678,7557,11217,112237,53157,78602,19522,30739,51247
00679,259,472,1049,821,1049,821,1293,2519
00680,7414,10873,141826,68332,91926,18432,29305,37589
00681,116,57,4,0,4,0,57,255
00682,24701,50011,105523,0,105498,0,50011,TIMEOUT
00683,61,68,42,17,42,17,85,369
00684,12683,62185,188282,46722,158345,16785,78970,TIMEOUT
00685,394,754,815,443,815,443,1197,3566
00687,184,92,0,0,0,0,92,182
00688,0,0,0,0,0,0,0,60
00689,1054,451,1412,0,1412,0,451,1008
00690,1291,975,3353,0,3353,0,975,2422
00691,0,276,0,0,0,0,276,166
00692,0,297,0,0,0,0,297,157
00693,0,0,0,0,0,0,0,71
00694,6207,1624,9686,0,9684,0,1624,5169
00695,7708,2842,15312,0,15308,0,2842,7835
00696,6207,1624,9677,0,9675,0,1624,4888
00697,7708,2842,15312,0,15308,0,2842,7937
00700,1053,1699,693,0,21327,0,1699,TIMEOUT
00701,861,1589,16613,173,26717,1,1590,TIMEOUT
00702,774,1321,4468,0,18346,0,1321,TIMEOUT
00703,1160,2004,14991,128,35553,1,2005,TIMEOUT
00704,355,616,7711,0,13362,0,616,TIMEOUT
00705,380,572,33428,0,37506,0,572,TIMEOUT
00706,342,520,9345,0,15654,0,520,TIMEOUT
00707,257,412,21010,0,26991,0,412,TIMEOUT
00708,125,215,112696,0,132303,0,215,TIMEOUT
00709,130,211,77622,0,90096,0,211,TIMEOUT
00710,240,356,47910,0,51026,0,356,TIMEOUT
00711,245,421,29265,0,35871,0,421,TIMEOUT
00712,502,993,18609,187,25265,1,994,TIMEOUT
00713,455,683,4630,0,12007,0,683,TIMEOUT
00714,193,298,51397,0,60620,0,298,TIMEOUT
00715,567,785,5066,0,17319,0,785,TIMEOUT
00716,640,995,1623,0,13513,0,995,TIMEOUT
00717,5,45,20,3,23,0,45,283
00718,97,182,179167,0,204469,0,182,TIMEOUT
00719,488,713,4710,0,11772,0,713,TIMEOUT
00720,190,364,53466,0,62835,0,364,TIMEOUT
00721,222,347,31459,0,38260,0,347,TIMEOUT
00722,411,753,10604,0,16565,0,753,TIMEOUT
00723,225,369,32629,0,39652,0,369,TIMEOUT
00724,828,1517,1964,0,13446,0,1517,TIMEOUT
00725,5,46,22,4,20,0,46,252
00726,283,571,38949,0,46796,0,571,TIMEOUT
00727,833,1567,11904,0,22096,0,1567,TIMEOUT
00728,728,1357,5141,281,19680,1,1358,TIMEOUT
00729,54,124,404440,0,467486,0,124,TIMEOUT
00730,3,43,10,2,9,0,43,232
00731,148,252,64048,0,72500,0,252,TIMEOUT
00732,402,633,12176,0,18984,0,633,TIMEOUT
00733,702,1086,1466,0,15009,0,1086,TIMEOUT
00734,78,148,202698,0,230899,0,148,TIMEOUT
00735,290,455,27757,0,35445,0,455,TIMEOUT
00736,7,52,37,4,37,0,52,269
00737,227,350,21455,0,27043,0,350,TIMEOUT
00738,159,301,105113,0,123540,0,301,TIMEOUT
00739,234,412,41917,0,50026,0,412,TIMEOUT
00740,289,477,28325,0,34724,0,477,TIMEOUT
00741,752,1225,3502,0,12865,0,1225,TIMEOUT
00742,191,312,46426,0,55084,0,312,TIMEOUT
00743,708,1486,14178,0,22003,0,1486,TIMEOUT
00744,228,430,29970,0,36646,0,430,TIMEOUT
00745,329,528,30104,0,34229,0,528,TIMEOUT
00746,490,768,12349,0,19130,0,768,TIMEOUT
00747,419,686,18746,0,24178,0,686,TIMEOUT
00748,223,398,40183,0,49244,0,398,TIMEOUT
00749,469,820,6410,0,13248,0,820,TIMEOUT
00750,209,416,45853,0,54172,0,416,TIMEOUT
00751,248,391,20321,0,25649,0,391,TIMEOUT
00752,772,1309,1864,0,15083,0,1309,TIMEOUT
00753,207,337,31374,0,39163,0,337,TIMEOUT
00755,459,756,13285,0,19637,0,756,TIMEOUT
00756,578,950,3090,0,13424,0,950,TIMEOUT
00758,14319,67400,42404,1509,44295,427,67827,TIMEOUT
00759,2532,5318,16188,1569,14705,88,5406,7143
00760,50814,170834,2588,2277,696,385,171219,TIMEOUT
00761,5598,13153,22998,15881,8836,1719,14872,TIMEOUT
00762,2508,6634,131659,91727,65998,26066,32700,292333
00763,124,311,517,202,373,58,369,678
00764,14319,67400,34806,1523,36237,427,67827,TIMEOUT
00765,0,11,0,0,0,0,11,109
00766,218,1845,78047,47913,48470,18336,20181,13327
00767,0,39,0,0,0,0,39,119
00768,2532,5753,16531,1912,14705,88,5841,7382
00769,2532,2654,11967,0,11965,0,2654,6668
00770,2532,2667,15879,1260,14705,88,2755,8050
00771,0,2,0,0,0,0,2,105
00772,6,653,79559,11246,71478,3,656,37563
00773,53,577,1673,1026,688,41,618,1337
00774,53,577,1969,1322,688,41,618,1439
00775,52,341,209466,22112,191345,9,350,TIMEOUT
00776,0,92,0,0,0,0,92,126
00777,0,92,0,0,0,0,92,153
00778,42054,113189,6338,3087,3807,556,113745,TIMEOUT
00779,N/A,N/A,N/A,N/A,N/A,N/A,N/A,ERROR
00780,0,223,0,0,0,0,223,136
00781,12,417,2213113,700321,1517408,387,804,TIMEOUT
00782,12,417,2312524,712119,1605134,443,860,TIMEOUT
00783,12,415,1562093,445594,1119769,401,816,TIMEOUT
00784,63,987,829,393,460,25,1012,966
00787,45442,59419,2241,1544,792,86,59505,TIMEOUT
00788,10,2538,539959,56172,500456,12,2550,TIMEOUT
00789,7,2580,506120,49915,473264,10,2590,280356
00790,7,2783,411009,75515,352553,10,2793,243847
00791,8665,41060,225254,133917,137524,46187,87247,TIMEOUT
00792,27874,42592,74107,1862,73918,5,42597,TIMEOUT
00793,152,144,3299,2132,1279,92,236,1615
00794,9484,10114,770094,402483,419028,51417,61531,TIMEOUT
00795,47412,65393,11409,9827,8618,7039,72431,TIMEOUT
00796,43604,100787,11829,676,12644,0,100787,TIMEOUT
00797,225554,236447,59035,10246,64768,790,237237,TIMEOUT
